TILEMAP
40 30 							-- Size of tile map in tiles
8 8 							-- Tile size & block size
images/tiles.png 	-- Tilesheet
40 30 							-- Number of tiles in tilesheet
308,308,308,430,0,0,0,428,308,308,308,308,308,308,308,308,308,308,308,308,308,308,308,308,308,308,308,308,308,308,308,308,308,308,308,308,308,308,308,308,
308,308,308,430,0,0,0,428,308,308,308,308,308,308,308,308,308,308,308,308,308,308,308,308,308,308,308,308,308,308,308,308,308,308,308,308,308,308,308,308,
308,308,308,430,0,0,0,428,308,308,308,308,308,308,308,308,308,308,308,308,308,308,308,308,308,308,308,308,308,308,308,308,308,308,308,308,308,308,308,308,
308,308,308,430,0,0,0,428,308,308,308,308,308,308,309,469,469,469,469,310,308,308,309,469,469,469,469,310,308,308,308,308,308,308,308,308,308,308,308,308,
308,308,308,430,0,0,0,428,308,308,308,308,308,308,430,0,0,0,0,428,308,308,430,0,0,0,0,428,308,308,308,308,308,308,308,308,308,308,308,308,
308,308,308,430,0,0,0,428,308,308,308,308,308,308,430,0,0,0,0,428,308,308,430,0,0,0,0,428,308,308,308,308,308,308,308,308,308,308,308,308,
308,308,308,430,0,0,0,428,308,308,308,308,308,308,430,0,0,0,0,428,308,308,430,0,0,0,0,428,308,308,308,308,308,308,308,308,308,308,308,308,
308,308,308,430,0,0,0,428,308,308,308,308,308,308,430,0,0,0,0,428,308,308,430,0,0,0,0,428,308,308,308,308,308,308,308,308,308,308,308,308,
308,308,308,430,0,0,0,468,469,469,469,469,469,469,470,0,0,0,0,468,469,469,470,0,0,0,0,428,308,308,308,308,308,308,308,308,308,308,308,308,
308,308,308,430,0,0,0,10,10,10,10,10,10,10,10,0,0,0,0,10,10,10,10,0,0,0,0,428,308,308,308,308,308,308,308,308,308,308,308,308,
308,308,308,430,0,0,0,0,0,0,0,0,0,0,0,0,0,0,0,0,0,0,0,0,0,0,0,428,308,308,308,308,308,308,308,308,308,308,308,308,
308,308,308,430,0,0,0,0,0,0,0,0,0,0,0,0,0,0,0,0,0,0,0,0,0,0,0,468,469,469,469,469,469,469,469,469,310,308,308,308,
308,308,308,430,0,0,0,0,0,0,0,0,0,0,0,0,0,0,0,0,0,0,0,0,0,0,0,10,10,10,10,10,10,10,10,10,428,308,308,308,
308,308,308,430,0,0,0,0,0,0,0,0,0,0,0,0,0,0,0,0,0,0,0,0,0,0,0,0,0,0,0,0,0,0,0,0,428,308,308,308,
308,308,308,430,0,0,0,0,0,0,0,0,0,0,0,0,0,0,0,0,0,0,0,0,0,0,0,0,0,0,0,0,0,0,0,0,428,308,308,308,
308,308,308,430,0,0,0,0,0,0,0,0,9,9,9,0,0,0,0,0,0,0,0,0,0,0,0,0,0,0,0,0,0,0,0,0,428,308,308,308,
308,308,308,430,0,0,0,0,0,0,0,0,388,389,390,0,0,0,0,0,0,0,0,0,0,0,0,0,0,0,0,0,0,0,0,0,428,308,308,308,
308,308,308,430,0,0,0,0,0,0,0,0,428,308,430,0,0,0,0,0,0,0,0,0,0,0,0,0,0,0,0,0,0,0,0,0,428,308,308,308,
308,308,308,430,0,0,0,0,0,0,0,0,428,308,430,0,0,0,0,9,9,9,9,0,0,0,0,9,9,9,0,0,0,0,0,0,428,308,308,308,
308,308,308,430,0,0,0,0,0,0,0,0,428,308,430,0,0,0,0,388,389,389,390,0,0,0,0,388,389,390,9,9,9,0,0,0,428,308,308,308,
308,308,308,430,0,0,0,0,0,0,0,0,428,308,430,0,0,0,0,428,308,308,430,0,0,0,0,428,308,349,389,389,390,0,0,0,428,308,308,308,
308,308,308,430,9,9,9,9,0,0,0,0,428,308,349,389,389,389,389,350,308,308,349,389,389,389,389,350,308,308,308,308,430,0,0,0,428,308,308,308,
308,308,308,349,389,389,389,390,0,0,0,0,428,308,308,308,308,309,469,469,469,469,469,469,469,469,469,469,469,469,469,469,470,0,0,0,428,308,308,308,
308,308,308,308,308,308,308,430,0,0,0,0,428,308,308,308,308,430,0,0,0,0,0,0,0,0,0,0,0,0,0,0,0,0,0,0,428,308,308,308,
308,308,308,308,308,308,308,430,0,0,0,0,428,308,308,308,308,430,0,0,0,0,0,0,0,0,0,0,0,0,0,0,0,0,0,0,428,308,308,308,
308,308,308,308,308,308,308,430,0,0,0,0,428,308,308,308,308,430,0,0,0,0,0,0,0,0,0,0,0,0,0,0,0,0,0,0,428,308,308,308,
308,308,308,308,308,308,308,349,389,389,389,389,350,308,308,308,308,430,0,0,0,0,388,389,389,389,389,389,389,389,389,389,389,389,389,389,350,308,308,308,
308,308,308,308,308,308,308,308,308,308,308,308,308,308,308,308,308,430,0,0,0,0,428,308,308,308,308,308,308,308,308,308,308,308,308,308,308,308,308,308,
308,308,308,308,308,308,308,308,308,308,308,308,308,308,308,308,308,430,0,0,0,0,428,308,308,308,308,308,308,308,308,308,308,308,308,308,308,308,308,308,
308,308,308,308,308,308,308,308,308,308,308,308,308,308,308,308,308,430,0,0,0,0,428,308,308,308,308,308,308,308,308,308,308,308,308,308,308,308,308,308
