TILEMAP
40 30 							-- Size of tile map in tiles
8 8 							-- Tile size & block size
images/tiles.png 	-- Tilesheet
40 30 							-- Number of tiles in tilesheet
517, 517, 517, 517, 517, 517, 517, 517, 517, 517, 517, 517, 517, 517, 517, 517, 517, 517, 517, 517, 517, 517, 517, 517, 517, 517, 517, 517, 517, 517, 517, 517, 517, 517, 517, 517, 517, 517, 517, 517,
517, 517, 517, 517, 517, 517, 517, 517, 517, 517, 517, 517, 517, 517, 517, 517, 517, 517, 517, 517, 517, 517, 517, 517, 517, 517, 517, 517, 517, 517, 517, 517, 517, 517, 517, 517, 517, 517, 517, 517,
517, 517, 517, 517, 517, 517, 517, 517, 517, 517, 517, 517, 517, 517, 517, 517, 517, 517, 517, 517, 517, 517, 517, 517, 517, 517, 517, 517, 517, 517, 517, 517, 517, 517, 517, 517, 517, 517, 517, 517,
517, 517, 517, 517, 517, 517, 517, 517, 517, 518, 678, 678, 678, 678, 678, 678, 678, 678, 678, 678, 678, 678, 678, 678, 678, 678, 678, 678, 678, 678, 678, 678, 678, 678, 678, 678, 519, 517, 517, 517,
517, 517, 517, 517, 517, 517, 517, 517, 517, 639, 10, 10, 10, 10, 10, 10, 10, 10, 10, 10, 10, 10, 10, 10, 10, 10, 10, 10, 10, 10, 10, 10, 10, 10, 10, 10, 637, 517, 517, 517,
517, 517, 517, 517, 517, 517, 517, 517, 517, 639, 0, 0, 0, 0, 0, 0, 0, 0, 0, 0, 0, 0, 0, 0, 0, 0, 0, 0, 0, 0, 0, 0, 0, 0, 0, 0, 637, 517, 517, 517,
517, 517, 517, 517, 517, 517, 517, 517, 517, 639, 0, 0, 0, 0, 0, 0, 0, 0, 0, 0, 0, 0, 0, 0, 0, 0, 0, 0, 0, 0, 0, 0, 0, 0, 0, 0, 637, 517, 517, 517,
517, 517, 517, 517, 517, 517, 517, 517, 517, 639, 0, 0, 0, 0, 0, 0, 0, 0, 0, 0, 0, 0, 0, 0, 0, 0, 0, 0, 0, 0, 0, 0, 0, 0, 0, 0, 637, 517, 517, 517,
517, 517, 517, 517, 517, 517, 517, 517, 517, 639, 0, 0, 0, 0, 0, 0, 0, 0, 0, 0, 0, 0, 0, 0, 0, 0, 0, 0, 0, 0, 0, 0, 0, 0, 0, 0, 637, 517, 517, 517,
517, 517, 517, 517, 517, 517, 517, 517, 517, 639, 0, 0, 0, 0, 0, 0, 0, 0, 0, 0, 0, 0, 0, 0, 0, 0, 0, 0, 0, 0, 0, 0, 0, 0, 0, 0, 637, 517, 517, 517,
517, 517, 517, 517, 517, 517, 517, 517, 517, 639, 0, 0, 0, 0, 0, 0, 0, 0, 0, 0, 0, 0, 0, 0, 0, 0, 0, 0, 0, 0, 0, 0, 0, 0, 0, 0, 637, 517, 517, 517,
517, 517, 517, 517, 517, 517, 517, 517, 517, 639, 0, 0, 0, 0, 0, 0, 0, 0, 0, 0, 0, 0, 0, 0, 0, 0, 0, 0, 0, 0, 0, 0, 0, 0, 0, 0, 677, 678, 678, 678,
517, 517, 517, 517, 517, 517, 517, 517, 517, 639, 0, 0, 0, 0, 0, 0, 0, 0, 0, 0, 0, 0, 0, 0, 0, 0, 0, 0, 0, 0, 0, 0, 0, 0, 0, 0, 0, 0, 0, 0,
517, 517, 517, 517, 517, 518, 678, 678, 678, 679, 0, 0, 0, 0, 0, 0, 0, 0, 0, 0, 0, 0, 0, 0, 0, 0, 0, 0, 0, 0, 0, 0, 0, 0, 0, 0, 0, 0, 0, 0,
517, 517, 517, 517, 517, 639, 0, 0, 0, 0, 0, 0, 0, 0, 0, 0, 0, 0, 0, 0, 0, 0, 0, 0, 0, 0, 0, 0, 0, 0, 0, 0, 0, 0, 0, 0, 0, 0, 0, 0,
517, 517, 517, 517, 517, 639, 0, 0, 0, 0, 0, 0, 0, 0, 0, 0, 0, 0, 0, 0, 0, 0, 0, 0, 0, 0, 0, 0, 0, 0, 0, 0, 0, 0, 0, 0, 0, 0, 0, 0,
517, 517, 517, 517, 517, 639, 0, 0, 0, 0, 0, 0, 0, 0, 0, 0, 0, 0, 0, 0, 0, 0, 0, 0, 0, 0, 0, 0, 0, 0, 0, 0, 0, 0, 0, 0, 0, 0, 0, 0,
678, 678, 678, 678, 678, 679, 0, 0, 0, 0, 0, 0, 0, 0, 0, 0, 0, 0, 0, 0, 0, 0, 0, 0, 0, 0, 0, 0, 0, 0, 0, 0, 0, 0, 0, 0, 597, 598, 598, 598,
0, 0, 0, 0, 0, 0, 0, 0, 0, 0, 0, 0, 0, 0, 0, 0, 0, 0, 0, 0, 0, 0, 0, 0, 0, 0, 0, 0, 0, 0, 0, 0, 0, 0, 0, 0, 637, 517, 517, 517,
0, 0, 0, 0, 0, 0, 0, 0, 0, 0, 0, 0, 0, 0, 0, 0, 0, 0, 0, 0, 0, 0, 0, 0, 0, 0, 0, 0, 0, 0, 0, 0, 0, 0, 0, 0, 637, 517, 517, 517,
0, 0, 0, 0, 0, 0, 0, 0, 0, 0, 0, 0, 0, 0, 0, 0, 0, 0, 0, 0, 0, 0, 0, 0, 0, 0, 0, 0, 0, 0, 0, 0, 0, 0, 0, 0, 637, 517, 517, 517,
0, 0, 0, 0, 0, 0, 0, 0, 0, 0, 0, 0, 0, 0, 0, 0, 0, 0, 0, 0, 0, 0, 0, 0, 0, 0, 0, 0, 0, 0, 0, 0, 0, 0, 0, 0, 637, 517, 517, 517,
0, 0, 0, 0, 0, 0, 0, 0, 0, 0, 0, 0, 0, 0, 0, 0, 0, 0, 0, 0, 0, 0, 0, 0, 0, 0, 0, 0, 0, 0, 0, 0, 0, 0, 0, 0, 637, 517, 517, 517,
0, 0, 0, 0, 0, 0, 0, 0, 0, 0, 0, 0, 0, 0, 0, 0, 0, 0, 0, 0, 0, 0, 0, 0, 0, 0, 0, 0, 0, 0, 0, 0, 0, 0, 0, 0, 637, 517, 517, 517,
0, 0, 0, 0, 0, 0, 0, 0, 0, 0, 0, 0, 0, 0, 0, 0, 0, 0, 0, 0, 0, 0, 0, 0, 0, 0, 0, 0, 0, 0, 0, 0, 0, 0, 0, 0, 637, 517, 517, 517,
9, 9, 9, 9, 9, 9, 9, 9, 9, 9, 9, 9, 9, 9, 9, 9, 9, 9, 9, 9, 9, 9, 9, 9, 9, 9, 9, 9, 9, 9, 9, 9, 9, 9, 9, 9, 637, 517, 517, 517,
598, 598, 598, 598, 598, 598, 598, 598, 598, 598, 598, 598, 598, 598, 598, 598, 598, 598, 598, 598, 598, 598, 598, 598, 598, 598, 598, 598, 598, 598, 598, 598, 598, 598, 598, 598, 559, 517, 517, 517,
517, 517, 517, 517, 517, 517, 517, 517, 517, 517, 517, 517, 517, 517, 517, 517, 517, 517, 517, 517, 517, 517, 517, 517, 517, 517, 517, 517, 517, 517, 517, 517, 517, 517, 517, 517, 517, 517, 517, 517,
517, 517, 517, 517, 517, 517, 517, 517, 517, 517, 517, 517, 517, 517, 517, 517, 517, 517, 517, 517, 517, 517, 517, 517, 517, 517, 517, 517, 517, 517, 517, 517, 517, 517, 517, 517, 517, 517, 517, 517,
517, 517, 517, 517, 517, 517, 517, 517, 517, 517, 517, 517, 517, 517, 517, 517, 517, 517, 517, 517, 517, 517, 517, 517, 517, 517, 517, 517, 517, 517, 517, 517, 517, 517, 517, 517, 517, 517, 517, 517