TILEMAP
40 30 							-- Size of tile map in tiles
8 8 							-- Tile size & block size
images/tiles.png 	-- Tilesheet
40 30 							-- Number of tiles in tilesheet
696, 696, 696, 696, 696, 696, 696, 696, 696, 696, 696, 696, 696, 696, 696, 696, 696, 696, 696, 696, 696, 696, 696, 696, 696, 696, 696, 696, 696, 696, 696, 696, 696, 696, 696, 696, 696, 696, 696, 696,
696, 696, 696, 696, 696, 696, 696, 696, 696, 696, 696, 696, 696, 696, 696, 696, 696, 696, 696, 696, 696, 696, 696, 696, 696, 696, 696, 696, 696, 696, 696, 696, 696, 696, 696, 696, 696, 696, 696, 696,
696, 696, 696, 696, 696, 696, 696, 696, 696, 696, 696, 696, 696, 696, 696, 696, 696, 696, 696, 696, 696, 696, 696, 696, 696, 696, 696, 696, 696, 696, 696, 696, 696, 696, 696, 696, 696, 696, 696, 696,
857, 857, 857, 857, 857, 857, 857, 698, 696, 696, 697, 857, 857, 857, 857, 857, 857, 857, 857, 857, 857, 857, 857, 857, 857, 857, 857, 857, 857, 857, 857, 857, 857, 857, 857, 857, 698, 696, 696, 696,
0, 0, 0, 0, 0, 0, 0, 816, 696, 696, 818, 10, 10, 10, 10, 10, 10, 10, 10, 10, 10, 10, 10, 10, 816, 696, 696, 696, 816, 696, 696, 696, 816, 696, 696, 696, 816, 696, 696, 696,
0, 0, 0, 0, 0, 0, 0, 816, 696, 696, 818, 0, 0, 0, 0, 0, 0, 0, 0, 0, 0, 0, 0, 0, 816, 696, 696, 696, 816, 696, 696, 696, 816, 696, 696, 696, 816, 696, 696, 696,
0, 0, 0, 0, 0, 0, 0, 816, 696, 696, 818, 0, 0, 0, 0, 0, 0, 0, 0, 0, 0, 0, 0, 0, 816, 696, 696, 696, 816, 696, 696, 696, 816, 696, 696, 696, 816, 696, 696, 696,
0, 0, 0, 0, 0, 0, 0, 816, 696, 696, 818, 0, 0, 0, 0, 0, 0, 0, 0, 0, 0, 0, 0, 0, 816, 696, 696, 696, 816, 696, 696, 696, 816, 696, 696, 696, 816, 696, 696, 696,
0, 0, 0, 0, 0, 0, 0, 816, 696, 696, 818, 0, 0, 0, 0, 0, 0, 0, 0, 0, 0, 0, 0, 0, 856, 857, 857, 857, 816, 696, 696, 696, 816, 696, 696, 696, 816, 696, 696, 696,
777, 777, 777, 778, 0, 0, 0, 816, 696, 696, 818, 0, 0, 0, 0, 0, 0, 0, 0, 0, 0, 0, 0, 0, 0, 0, 0, 0, 816, 696, 696, 696, 816, 696, 696, 696, 816, 696, 696, 696,
696, 697, 857, 858, 0, 0, 0, 856, 857, 857, 858, 0, 0, 0, 0, 0, 0, 0, 0, 0, 0, 0, 0, 0, 0, 0, 0, 0, 816, 696, 696, 696, 816, 696, 696, 696, 816, 696, 696, 696,
696, 818, 0, 0, 0, 0, 0, 0, 0, 0, 0, 0, 0, 0, 0, 0, 0, 776, 777, 777, 778, 0, 0, 0, 0, 0, 0, 0, 816, 696, 696, 696, 816, 696, 696, 696, 816, 696, 696, 696,
696, 737, 777, 778, 0, 0, 0, 776, 777, 777, 778, 0, 0, 0, 0, 0, 0, 816, 696, 696, 818, 0, 0, 0, 0, 0, 0, 0, 816, 696, 696, 696, 816, 696, 696, 696, 816, 696, 696, 696,
857, 857, 857, 858, 0, 0, 0, 816, 696, 696, 818, 0, 0, 0, 0, 0, 0, 816, 696, 696, 818, 0, 0, 0, 0, 0, 0, 0, 856, 857, 857, 857, 816, 696, 696, 696, 816, 696, 696, 696,
0, 0, 0, 0, 0, 0, 0, 816, 696, 696, 818, 0, 0, 0, 0, 0, 0, 816, 696, 696, 818, 0, 0, 0, 0, 0, 0, 0, 0, 0, 0, 0, 816, 696, 696, 696, 816, 696, 696, 696,
0, 0, 0, 0, 0, 0, 0, 816, 696, 696, 818, 0, 0, 0, 0, 0, 0, 816, 696, 696, 818, 0, 0, 0, 0, 0, 0, 0, 0, 0, 0, 0, 816, 696, 696, 696, 816, 696, 696, 696,
0, 0, 0, 0, 0, 0, 0, 816, 696, 696, 818, 0, 0, 0, 0, 0, 0, 816, 696, 696, 818, 777, 777, 777, 778, 0, 0, 0, 0, 0, 0, 0, 816, 696, 696, 696, 816, 696, 696, 696,
0, 0, 0, 0, 0, 0, 0, 816, 696, 696, 818, 0, 0, 0, 0, 0, 0, 816, 696, 696, 818, 696, 696, 696, 818, 0, 0, 0, 0, 0, 0, 0, 816, 696, 696, 696, 816, 696, 696, 696,
0, 0, 0, 0, 0, 0, 0, 856, 857, 857, 858, 0, 0, 0, 0, 0, 0, 816, 696, 696, 818, 696, 696, 696, 818, 0, 0, 0, 0, 0, 0, 0, 856, 857, 857, 857, 816, 696, 696, 696,
817, 817, 817, 817, 817, 817, 817, 817, 817, 817, 817, 0, 0, 0, 0, 0, 0, 816, 696, 696, 818, 696, 696, 696, 818, 0, 0, 0, 0, 0, 0, 0, 0, 0, 0, 0, 816, 696, 696, 696,
817, 817, 817, 817, 817, 817, 817, 817, 817, 817, 817, 0, 0, 0, 0, 0, 0, 816, 696, 696, 818, 696, 696, 696, 818, 0, 0, 0, 0, 0, 0, 0, 0, 0, 0, 0, 816, 696, 696, 696,
10, 10, 10, 10, 10, 10, 10, 10, 10, 10, 10, 0, 0, 0, 0, 0, 0, 816, 696, 696, 818, 696, 696, 696, 818, 777, 777, 777, 778, 0, 0, 0, 0, 0, 0, 0, 856, 857, 857, 857,
0, 0, 0, 0, 0, 0, 0, 0, 0, 0, 0, 0, 0, 0, 0, 0, 0, 816, 696, 696, 818, 696, 696, 696, 818, 696, 696, 696, 818, 0, 0, 0, 0, 0, 0, 0, 0, 0, 0, 0,
0, 0, 0, 0, 0, 0, 0, 0, 0, 0, 0, 0, 0, 0, 0, 0, 0, 816, 696, 696, 818, 696, 696, 696, 818, 696, 696, 696, 818, 0, 0, 0, 0, 0, 0, 0, 0, 0, 0, 0,
0, 0, 0, 0, 0, 0, 0, 0, 0, 0, 0, 0, 0, 0, 0, 0, 0, 816, 696, 696, 818, 696, 696, 696, 818, 696, 696, 696, 818, 0, 0, 0, 0, 0, 0, 0, 0, 0, 0, 0,
0, 0, 0, 0, 0, 0, 0, 0, 0, 0, 0, 0, 0, 0, 0, 0, 0, 856, 857, 857, 858, 857, 857, 857, 858, 857, 857, 857, 858, 0, 0, 0, 0, 0, 0, 0, 0, 0, 0, 0,
777, 777, 777, 777, 777, 777, 777, 777, 777, 777, 777, 777, 777, 777, 777, 777, 777, 777, 777, 777, 777, 777, 777, 777, 777, 777, 777, 777, 777, 777, 777, 777, 777, 777, 777, 777, 777, 777, 777, 777,
696, 696, 696, 696, 696, 696, 696, 696, 696, 696, 696, 696, 696, 696, 696, 696, 696, 696, 696, 696, 696, 696, 696, 696, 696, 696, 696, 696, 696, 696, 696, 696, 696, 696, 696, 696, 696, 696, 696, 696,
696, 696, 696, 696, 696, 696, 696, 696, 696, 696, 696, 696, 696, 696, 696, 696, 696, 696, 696, 696, 696, 696, 696, 696, 696, 696, 696, 696, 696, 696, 696, 696, 696, 696, 696, 696, 696, 696, 696, 696,
696, 696, 696, 696, 696, 696, 696, 696, 696, 696, 696, 696, 696, 696, 696, 696, 696, 696, 696, 696, 696, 696, 696, 696, 696, 696, 696, 696, 696, 696, 696, 696, 696, 696, 696, 696, 696, 696, 696, 696