TILEMAP
40 30 							-- Size of tile map in tiles
8 8 							-- Tile size & block size
images/tiles.png 	-- Tilesheet
40 30 							-- Number of tiles in tilesheet
699, 699, 699, 699, 699, 699, 699, 699, 699, 699, 699, 699, 699, 699, 699, 699, 699, 821, 0, 0, 0, 0, 0, 819, 699, 699, 699, 699, 699, 699, 699, 699, 699, 699, 699, 699, 699, 699, 699, 699,
699, 699, 699, 699, 699, 699, 699, 699, 699, 699, 699, 699, 699, 699, 699, 699, 699, 821, 0, 0, 0, 0, 0, 819, 699, 699, 699, 699, 699, 699, 699, 699, 699, 699, 699, 699, 699, 699, 699, 699,
699, 699, 699, 699, 699, 699, 699, 699, 699, 699, 699, 699, 699, 699, 699, 699, 699, 821, 0, 0, 0, 0, 0, 819, 699, 699, 699, 699, 699, 699, 699, 699, 699, 699, 699, 699, 699, 699, 699, 699,
699, 699, 699, 700, 860, 860, 860, 860, 860, 860, 860, 860, 860, 860, 860, 860, 860, 861, 0, 0, 0, 0, 0, 859, 860, 860, 860, 860, 860, 860, 860, 860, 860, 860, 860, 860, 701, 699, 699, 699,
699, 699, 699, 821, 0, 0, 0, 0, 0, 0, 0, 0, 0, 0, 0, 0, 0, 820, 0, 0, 0, 0, 0, 820, 0, 0, 0, 0, 0, 0, 0, 0, 0, 0, 0, 0, 819, 699, 699, 699,
699, 699, 699, 821, 0, 0, 0, 0, 0, 0, 0, 0, 0, 0, 0, 0, 0, 820, 0, 0, 0, 0, 0, 820, 0, 0, 0, 0, 0, 0, 0, 0, 0, 0, 0, 0, 819, 699, 699, 699,
699, 699, 699, 821, 0, 0, 0, 0, 0, 0, 0, 0, 0, 0, 0, 0, 0, 820, 0, 0, 0, 0, 0, 820, 0, 0, 0, 0, 0, 0, 0, 0, 0, 0, 0, 0, 819, 699, 699, 699,
699, 699, 699, 821, 0, 0, 0, 0, 0, 0, 0, 0, 0, 0, 0, 0, 0, 820, 0, 0, 0, 0, 0, 820, 0, 0, 0, 0, 0, 0, 0, 0, 0, 0, 0, 0, 819, 699, 699, 699,
699, 699, 699, 821, 0, 0, 0, 0, 820, 0, 0, 0, 0, 0, 0, 0, 0, 820, 0, 0, 0, 0, 0, 820, 0, 0, 0, 0, 0, 0, 0, 0, 0, 0, 0, 0, 819, 699, 699, 699,
699, 699, 699, 821, 0, 0, 0, 0, 820, 0, 0, 0, 0, 0, 0, 0, 0, 820, 0, 0, 0, 0, 0, 820, 0, 0, 0, 0, 0, 0, 0, 0, 0, 0, 0, 0, 819, 699, 699, 699,
699, 699, 699, 821, 0, 0, 0, 0, 820, 0, 0, 0, 0, 0, 0, 0, 0, 820, 0, 0, 0, 0, 0, 0, 0, 0, 0, 0, 0, 0, 0, 820, 0, 0, 0, 0, 819, 699, 699, 699,
699, 699, 699, 821, 0, 0, 0, 0, 820, 0, 0, 0, 0, 0, 0, 0, 0, 820, 0, 0, 0, 0, 0, 0, 0, 0, 0, 0, 0, 0, 0, 820, 0, 0, 0, 0, 819, 699, 699, 699,
699, 699, 699, 821, 0, 0, 0, 0, 820, 0, 0, 0, 0, 0, 0, 0, 0, 820, 0, 0, 0, 0, 0, 0, 0, 0, 0, 0, 0, 0, 0, 820, 0, 0, 0, 0, 819, 699, 699, 699,
699, 699, 699, 821, 0, 0, 0, 0, 820, 0, 0, 0, 0, 0, 0, 0, 0, 820, 0, 0, 0, 0, 0, 0, 0, 0, 0, 0, 0, 0, 0, 820, 0, 0, 0, 0, 819, 699, 699, 699,
699, 699, 699, 821, 0, 0, 0, 0, 820, 0, 0, 0, 0, 0, 0, 0, 0, 820, 0, 0, 0, 0, 0, 0, 0, 0, 0, 0, 0, 0, 0, 820, 0, 0, 0, 0, 819, 699, 699, 699,
699, 699, 699, 821, 0, 0, 0, 0, 820, 0, 0, 0, 0, 0, 0, 0, 0, 820, 0, 0, 0, 0, 0, 0, 0, 0, 0, 0, 0, 0, 0, 820, 0, 0, 0, 0, 819, 699, 699, 699,
699, 699, 699, 821, 0, 0, 0, 0, 820, 0, 0, 0, 0, 0, 0, 0, 0, 0, 0, 0, 0, 0, 0, 0, 0, 0, 0, 0, 0, 0, 0, 0, 0, 0, 0, 0, 819, 699, 699, 699,
699, 699, 699, 821, 0, 0, 0, 0, 820, 0, 0, 0, 0, 0, 0, 0, 0, 0, 0, 0, 0, 0, 0, 0, 0, 0, 0, 0, 0, 0, 0, 0, 0, 0, 0, 0, 819, 699, 699, 699,
699, 699, 699, 821, 0, 0, 0, 0, 820, 0, 0, 0, 0, 0, 0, 0, 0, 0, 0, 0, 0, 0, 0, 0, 0, 0, 0, 0, 0, 0, 0, 0, 0, 0, 0, 0, 819, 699, 699, 699,
699, 699, 699, 821, 0, 0, 0, 0, 820, 0, 0, 0, 0, 0, 0, 0, 0, 0, 0, 0, 0, 0, 0, 0, 0, 0, 0, 0, 0, 0, 0, 0, 0, 0, 0, 0, 819, 699, 699, 699,
699, 699, 699, 821, 0, 0, 0, 0, 820, 0, 0, 0, 0, 0, 0, 0, 0, 0, 0, 0, 0, 0, 0, 0, 0, 0, 0, 0, 0, 0, 0, 0, 0, 0, 0, 0, 819, 699, 699, 699,
860, 860, 860, 861, 0, 0, 0, 0, 820, 0, 0, 0, 0, 0, 0, 0, 0, 0, 0, 0, 0, 0, 0, 0, 0, 0, 0, 0, 0, 0, 0, 0, 0, 0, 0, 0, 819, 699, 699, 699,
0, 0, 0, 0, 0, 0, 0, 0, 820, 0, 0, 0, 0, 0, 0, 0, 0, 0, 0, 0, 0, 0, 0, 0, 0, 0, 0, 0, 0, 0, 0, 0, 0, 0, 0, 0, 819, 699, 699, 699,
0, 0, 0, 0, 0, 0, 0, 0, 820, 0, 0, 0, 0, 0, 0, 0, 0, 0, 0, 0, 0, 0, 0, 0, 0, 0, 0, 0, 0, 0, 0, 0, 0, 0, 0, 0, 819, 699, 699, 699,
0, 0, 0, 0, 0, 0, 0, 0, 820, 0, 0, 0, 0, 0, 0, 0, 0, 0, 0, 0, 0, 0, 0, 0, 0, 0, 0, 0, 0, 0, 0, 0, 0, 0, 0, 0, 819, 699, 699, 699,
0, 0, 0, 0, 0, 0, 0, 0, 820, 0, 0, 0, 0, 0, 0, 0, 0, 0, 0, 0, 0, 0, 0, 0, 0, 0, 0, 0, 0, 0, 0, 0, 0, 0, 0, 0, 819, 699, 699, 699,
780, 780, 780, 780, 780, 780, 780, 780, 780, 780, 780, 780, 780, 780, 780, 780, 780, 780, 780, 780, 780, 780, 780, 780, 780, 780, 780, 780, 780, 780, 780, 780, 780, 780, 780, 780, 741, 699, 699, 699,
699, 699, 699, 699, 699, 699, 699, 699, 699, 699, 699, 699, 699, 699, 699, 699, 699, 699, 699, 699, 699, 699, 699, 699, 699, 699, 699, 699, 699, 699, 699, 699, 699, 699, 699, 699, 699, 699, 699, 699,
699, 699, 699, 699, 699, 699, 699, 699, 699, 699, 699, 699, 699, 699, 699, 699, 699, 699, 699, 699, 699, 699, 699, 699, 699, 699, 699, 699, 699, 699, 699, 699, 699, 699, 699, 699, 699, 699, 699, 699,
699, 699, 699, 699, 699, 699, 699, 699, 699, 699, 699, 699, 699, 699, 699, 699, 699, 699, 699, 699, 699, 699, 699, 699, 699, 699, 699, 699, 699, 699, 699, 699, 699, 699, 699, 699, 699, 699, 699, 699