TILEMAP
40 30 							-- Size of tile map in tiles
8 8 							-- Tile size & block size
images/tiles.png 	-- Tilesheet
40 30 							-- Number of tiles in tilesheet
487, 487, 487, 487, 487, 487, 487, 487, 487, 487, 487, 487, 487, 487, 487, 487, 487, 487, 487, 487, 487, 487, 487, 487, 487, 487, 487, 487, 487, 487, 487, 487, 487, 487, 487, 487, 487, 487, 487, 487,
487, 487, 487, 487, 487, 487, 487, 487, 487, 487, 487, 487, 487, 487, 487, 487, 487, 487, 487, 487, 487, 487, 487, 487, 487, 487, 487, 487, 487, 487, 487, 487, 487, 487, 487, 487, 487, 487, 487, 487,
487, 487, 487, 487, 487, 487, 487, 487, 487, 487, 487, 487, 487, 487, 487, 487, 487, 487, 487, 487, 487, 487, 487, 487, 487, 487, 487, 487, 487, 487, 487, 487, 487, 487, 487, 487, 487, 487, 487, 487,
487, 487, 487, 488, 648, 648, 648, 648, 648, 648, 648, 648, 648, 648, 648, 648, 648, 648, 648, 648, 648, 648, 648, 648, 648, 648, 648, 648, 648, 648, 648, 648, 648, 648, 648, 648, 648, 648, 648, 648,
487, 487, 487, 609, 908, 908, 908, 908, 908, 908, 908, 908, 908, 908, 908, 908, 908, 908, 908, 908, 908, 908, 908, 908, 908, 908, 908, 908, 908, 908, 908, 908, 908, 908, 0, 0, 0, 0, 0, 0,
487, 487, 487, 609, 0, 0, 0, 0, 0, 0, 0, 0, 0, 0, 0, 0, 0, 0, 0, 0, 0, 0, 0, 0, 0, 0, 0, 0, 0, 0, 0, 0, 0, 0, 0, 0, 0, 0, 0, 0,
487, 487, 487, 609, 0, 0, 0, 0, 0, 0, 0, 0, 0, 0, 0, 0, 0, 0, 0, 0, 0, 0, 0, 0, 0, 0, 0, 0, 0, 0, 0, 0, 0, 0, 0, 0, 0, 0, 0, 0,
487, 487, 487, 609, 0, 0, 0, 0, 0, 0, 0, 0, 0, 0, 0, 0, 0, 0, 0, 0, 0, 0, 0, 0, 0, 0, 0, 0, 0, 0, 0, 0, 0, 0, 0, 0, 0, 0, 0, 0,
487, 487, 487, 609, 0, 0, 0, 0, 0, 0, 0, 0, 0, 0, 0, 0, 0, 0, 0, 0, 0, 0, 0, 0, 0, 0, 0, 0, 0, 0, 0, 0, 0, 0, 0, 0, 567, 568, 568, 568,
487, 487, 487, 609, 0, 0, 0, 0, 0, 0, 0, 0, 0, 0, 0, 0, 0, 0, 0, 0, 0, 0, 0, 0, 0, 0, 0, 0, 0, 0, 0, 0, 0, 0, 0, 0, 607, 487, 487, 487,
487, 487, 487, 609, 0, 0, 0, 0, 0, 0, 0, 0, 0, 0, 0, 0, 0, 0, 0, 0, 0, 0, 0, 0, 0, 0, 0, 0, 0, 0, 0, 0, 0, 0, 0, 0, 607, 487, 487, 487,
487, 487, 487, 609, 0, 0, 0, 0, 0, 0, 0, 0, 0, 0, 0, 0, 0, 0, 0, 0, 0, 0, 0, 0, 0, 0, 0, 0, 0, 0, 0, 0, 0, 0, 0, 0, 607, 487, 487, 487,
487, 487, 487, 609, 0, 0, 0, 0, 0, 0, 0, 0, 0, 0, 0, 0, 0, 0, 0, 0, 0, 0, 0, 0, 0, 0, 0, 0, 0, 0, 0, 0, 0, 0, 0, 0, 607, 487, 487, 487,
487, 487, 487, 609, 0, 0, 0, 0, 0, 0, 0, 0, 0, 0, 0, 0, 0, 0, 0, 0, 0, 0, 0, 0, 0, 0, 0, 0, 0, 0, 0, 0, 0, 0, 0, 0, 607, 487, 487, 487,
487, 487, 487, 609, 0, 0, 0, 0, 0, 0, 0, 0, 0, 0, 0, 0, 0, 0, 0, 0, 0, 0, 0, 0, 0, 0, 0, 0, 0, 0, 0, 0, 0, 0, 0, 0, 607, 487, 487, 487,
487, 487, 487, 609, 0, 0, 0, 0, 0, 0, 0, 0, 0, 0, 0, 0, 0, 0, 0, 0, 0, 0, 0, 0, 0, 0, 0, 0, 0, 0, 0, 0, 0, 0, 0, 0, 607, 487, 487, 487,
487, 487, 487, 609, 0, 0, 0, 0, 0, 0, 0, 0, 0, 0, 0, 0, 0, 0, 0, 0, 0, 0, 0, 0, 0, 0, 0, 0, 0, 0, 0, 0, 0, 0, 0, 0, 607, 487, 487, 487,
487, 487, 487, 609, 0, 0, 0, 0, 0, 0, 0, 0, 0, 0, 0, 0, 0, 0, 0, 0, 0, 0, 0, 0, 0, 0, 0, 0, 0, 0, 0, 0, 0, 0, 0, 0, 607, 487, 487, 487,
487, 487, 487, 609, 0, 0, 0, 0, 0, 0, 0, 0, 0, 0, 0, 0, 0, 0, 0, 0, 0, 0, 0, 0, 0, 0, 0, 0, 0, 0, 0, 0, 0, 0, 0, 0, 607, 487, 487, 487,
487, 487, 487, 609, 0, 0, 0, 0, 0, 0, 0, 0, 0, 0, 0, 0, 0, 0, 0, 0, 0, 0, 0, 0, 0, 0, 0, 0, 0, 0, 0, 0, 0, 0, 0, 0, 607, 487, 487, 487,
487, 487, 487, 609, 0, 0, 0, 0, 0, 0, 0, 0, 0, 0, 0, 0, 0, 0, 0, 0, 0, 0, 0, 0, 0, 0, 0, 0, 0, 0, 0, 0, 0, 0, 0, 0, 607, 487, 487, 487,
487, 487, 487, 609, 0, 0, 0, 0, 0, 0, 0, 0, 0, 0, 0, 0, 0, 0, 0, 0, 0, 0, 0, 0, 0, 0, 0, 0, 0, 0, 0, 0, 0, 0, 0, 0, 607, 487, 487, 487,
487, 487, 487, 609, 0, 0, 0, 0, 0, 0, 0, 0, 0, 0, 0, 0, 0, 0, 0, 0, 0, 0, 0, 0, 0, 0, 0, 0, 0, 0, 0, 0, 0, 0, 0, 0, 607, 487, 487, 487,
487, 487, 487, 609, 0, 0, 0, 0, 0, 0, 0, 0, 0, 0, 0, 0, 0, 0, 0, 0, 0, 0, 0, 0, 0, 0, 0, 0, 0, 0, 0, 0, 0, 0, 0, 0, 607, 487, 487, 487,
487, 487, 487, 609, 0, 0, 0, 0, 0, 0, 0, 0, 0, 0, 0, 0, 0, 0, 0, 0, 0, 0, 0, 0, 0, 0, 0, 0, 0, 0, 0, 0, 0, 0, 0, 0, 607, 487, 487, 487,
487, 487, 487, 609, 948, 948, 948, 948, 948, 948, 948, 948, 948, 948, 948, 948, 948, 948, 948, 948, 948, 948, 948, 948, 948, 948, 948, 948, 948, 948, 948, 948, 948, 948, 948, 948, 607, 487, 487, 487,
487, 487, 487, 528, 568, 568, 568, 568, 568, 568, 568, 568, 568, 568, 568, 568, 568, 568, 568, 568, 568, 568, 568, 568, 568, 568, 568, 568, 568, 568, 568, 568, 568, 568, 568, 568, 529, 487, 487, 487,
487, 487, 487, 487, 487, 487, 487, 487, 487, 487, 487, 487, 487, 487, 487, 487, 487, 487, 487, 487, 487, 487, 487, 487, 487, 487, 487, 487, 487, 487, 487, 487, 487, 487, 487, 487, 487, 487, 487, 487,
487, 487, 487, 487, 487, 487, 487, 487, 487, 487, 487, 487, 487, 487, 487, 487, 487, 487, 487, 487, 487, 487, 487, 487, 487, 487, 487, 487, 487, 487, 487, 487, 487, 487, 487, 487, 487, 487, 487, 487,
487, 487, 487, 487, 487, 487, 487, 487, 487, 487, 487, 487, 487, 487, 487, 487, 487, 487, 487, 487, 487, 487, 487, 487, 487, 487, 487, 487, 487, 487, 487, 487, 487, 487, 487, 487, 487, 487, 487, 487