TILEMAP
40 30 							-- Size of tile map in tiles
8 8 							-- Tile size & block size
images/tiles.png 	-- Tilesheet
40 30 							-- Number of tiles in tilesheet
514, 514, 514, 514, 514, 514, 514, 514, 514, 514, 514, 514, 514, 514, 514, 514, 514, 636, 0, 0, 0, 0, 0, 634, 514, 514, 514, 514, 514, 514, 514, 514, 514, 514, 514, 514, 514, 514, 514, 514,
514, 514, 514, 514, 514, 514, 514, 514, 514, 514, 514, 514, 514, 514, 514, 514, 514, 636, 0, 0, 0, 0, 0, 634, 514, 514, 514, 514, 514, 514, 514, 514, 514, 514, 514, 514, 514, 514, 514, 514,
514, 514, 514, 514, 514, 514, 514, 514, 514, 514, 514, 514, 514, 514, 514, 514, 514, 636, 0, 0, 0, 0, 0, 634, 554, 554, 514, 514, 514, 514, 514, 514, 514, 514, 514, 514, 514, 514, 514, 514,
514, 515, 675, 675, 675, 675, 675, 675, 675, 675, 675, 675, 675, 675, 516, 514, 514, 636, 0, 0, 0, 0, 0, 634, 554, 554, 515, 675, 675, 675, 675, 675, 675, 675, 675, 675, 675, 675, 675, 675,
514, 636, 0, 0, 0, 0, 0, 0, 0, 0, 0, 0, 0, 0, 634, 514, 514, 636, 0, 0, 0, 0, 0, 634, 554, 554, 636, 0, 0, 0, 0, 0, 0, 0, 0, 0, 0, 0, 0, 0,
514, 636, 0, 0, 0, 0, 0, 0, 0, 0, 0, 0, 0, 0, 634, 514, 514, 636, 0, 0, 0, 0, 0, 634, 554, 554, 636, 0, 0, 0, 0, 0, 0, 0, 0, 0, 0, 0, 0, 0,
514, 636, 0, 0, 0, 0, 0, 0, 0, 0, 0, 0, 0, 0, 634, 514, 514, 636, 0, 0, 0, 0, 0, 634, 554, 554, 636, 0, 0, 0, 0, 0, 0, 0, 0, 0, 0, 0, 0, 0,
514, 636, 0, 0, 0, 0, 594, 595, 595, 596, 0, 0, 0, 0, 634, 514, 514, 636, 0, 0, 0, 0, 0, 634, 554, 554, 636, 0, 0, 0, 0, 0, 0, 0, 0, 0, 0, 0, 0, 0,
514, 636, 0, 0, 0, 0, 634, 514, 514, 636, 0, 0, 0, 0, 634, 514, 514, 636, 0, 0, 0, 0, 0, 634, 554, 554, 636, 0, 0, 0, 0, 0, 0, 0, 0, 0, 0, 0, 0, 0,
514, 636, 0, 0, 0, 0, 634, 514, 514, 636, 0, 0, 0, 0, 634, 514, 514, 636, 0, 0, 0, 0, 0, 634, 554, 554, 636, 0, 0, 0, 0, 594, 595, 595, 595, 595, 595, 595, 595, 595,
514, 636, 0, 0, 0, 0, 634, 514, 514, 636, 0, 0, 0, 0, 634, 514, 514, 636, 0, 0, 0, 0, 0, 634, 554, 554, 636, 0, 0, 0, 0, 634, 514, 514, 514, 514, 514, 514, 514, 514,
675, 676, 0, 0, 0, 0, 634, 514, 514, 636, 0, 0, 0, 0, 634, 514, 514, 636, 0, 0, 0, 0, 0, 634, 554, 554, 636, 0, 0, 0, 0, 634, 514, 514, 514, 514, 514, 514, 514, 514,
0, 0, 0, 0, 0, 0, 634, 514, 514, 636, 0, 0, 0, 0, 634, 514, 514, 636, 0, 0, 0, 0, 0, 634, 554, 554, 636, 0, 0, 0, 0, 674, 675, 675, 675, 516, 514, 514, 514, 514,
0, 0, 0, 0, 0, 0, 634, 514, 514, 636, 0, 0, 0, 0, 634, 514, 514, 636, 0, 0, 0, 0, 0, 634, 554, 554, 636, 0, 0, 0, 0, 0, 0, 0, 0, 634, 514, 514, 514, 514,
0, 0, 0, 0, 0, 0, 634, 514, 514, 636, 0, 0, 0, 0, 634, 514, 514, 636, 0, 0, 0, 0, 0, 634, 554, 554, 636, 0, 0, 0, 0, 0, 0, 0, 0, 634, 514, 514, 514, 514,
0, 0, 0, 0, 0, 0, 634, 514, 514, 636, 0, 0, 0, 0, 634, 514, 514, 636, 0, 0, 0, 0, 0, 634, 554, 554, 636, 0, 0, 0, 0, 0, 0, 0, 0, 634, 514, 514, 514, 514,
0, 0, 0, 0, 0, 0, 634, 514, 514, 636, 0, 0, 0, 0, 634, 514, 514, 636, 0, 0, 0, 0, 0, 634, 554, 554, 636, 0, 0, 0, 0, 0, 0, 0, 0, 634, 514, 514, 514, 514,
595, 595, 595, 595, 595, 595, 556, 514, 514, 636, 0, 0, 0, 0, 634, 514, 514, 636, 0, 0, 0, 0, 0, 634, 554, 554, 636, 0, 0, 0, 0, 594, 595, 595, 595, 556, 514, 514, 514, 514,
514, 514, 514, 514, 514, 514, 514, 514, 514, 636, 0, 0, 0, 0, 634, 514, 514, 636, 0, 0, 0, 0, 0, 634, 554, 554, 636, 0, 0, 0, 0, 634, 514, 514, 514, 514, 514, 514, 514, 514,
514, 515, 675, 675, 675, 675, 675, 675, 675, 676, 0, 0, 0, 0, 634, 514, 514, 636, 0, 0, 0, 0, 0, 634, 554, 554, 636, 0, 0, 0, 0, 634, 514, 514, 514, 514, 514, 514, 514, 514,
514, 636, 0, 0, 0, 0, 0, 0, 0, 0, 0, 0, 0, 0, 634, 514, 514, 636, 0, 0, 0, 0, 0, 634, 554, 554, 636, 0, 0, 0, 0, 674, 675, 675, 675, 675, 675, 675, 675, 675,
514, 636, 0, 0, 0, 0, 0, 0, 0, 0, 0, 0, 0, 0, 634, 514, 514, 636, 0, 0, 0, 0, 0, 634, 554, 554, 636, 0, 0, 0, 0, 0, 0, 0, 0, 0, 0, 0, 0, 0,
514, 636, 0, 0, 0, 0, 0, 0, 0, 0, 0, 0, 0, 0, 634, 514, 514, 636, 0, 0, 0, 0, 0, 634, 554, 554, 636, 0, 0, 0, 0, 0, 0, 0, 0, 0, 0, 0, 0, 0,
514, 636, 0, 0, 0, 0, 0, 0, 0, 0, 0, 0, 0, 0, 634, 514, 514, 636, 0, 0, 0, 0, 0, 634, 554, 554, 636, 0, 0, 0, 0, 0, 0, 0, 0, 0, 0, 0, 0, 0,
514, 636, 0, 0, 0, 0, 0, 0, 0, 0, 0, 0, 0, 0, 634, 514, 514, 636, 0, 0, 0, 0, 0, 634, 554, 554, 636, 0, 0, 0, 0, 0, 0, 0, 0, 0, 0, 0, 0, 0,
514, 636, 0, 0, 0, 0, 0, 0, 0, 0, 0, 0, 0, 0, 634, 514, 514, 636, 0, 0, 0, 0, 0, 634, 554, 554, 636, 0, 0, 0, 0, 0, 0, 0, 0, 0, 0, 0, 0, 0,
514, 555, 595, 595, 595, 595, 595, 595, 595, 595, 595, 595, 595, 595, 556, 514, 514, 636, 0, 0, 0, 0, 0, 634, 554, 554, 555, 595, 595, 595, 595, 595, 595, 595, 595, 595, 595, 595, 595, 595,
514, 514, 514, 514, 514, 514, 514, 514, 514, 514, 514, 514, 514, 514, 514, 514, 514, 636, 0, 0, 0, 0, 0, 634, 554, 554, 514, 514, 514, 514, 514, 514, 514, 514, 514, 514, 514, 514, 514, 514,
514, 514, 514, 514, 514, 514, 514, 514, 514, 514, 514, 514, 514, 514, 514, 514, 514, 636, 0, 0, 0, 0, 0, 634, 554, 514, 514, 514, 514, 514, 514, 514, 514, 514, 514, 514, 514, 514, 514, 514,
514, 514, 514, 514, 514, 514, 514, 514, 514, 514, 514, 514, 514, 514, 514, 514, 514, 636, 0, 0, 0, 0, 0, 634, 514, 514, 514, 514, 514, 514, 514, 514, 514, 514, 514, 514, 514, 514, 514, 514
