TILEMAP
40 30 							-- Size of tile map in tiles
8 8 							-- Tile size & block size
images/tiles.png 	-- Tilesheet
40 30 							-- Number of tiles in tilesheet
117, 117, 117, 117, 117, 117, 117, 117, 117, 117, 117, 117, 117, 117, 117, 117, 117, 239, 0, 0, 0, 0, 237, 117, 117, 117, 117, 117, 117, 117, 117, 117, 117, 117, 117, 117, 117, 117, 117, 117,
117, 117, 117, 117, 117, 117, 117, 117, 117, 117, 117, 117, 117, 117, 117, 117, 117, 239, 0, 0, 0, 0, 237, 117, 117, 117, 117, 117, 117, 117, 117, 117, 117, 117, 117, 117, 117, 117, 117, 117,
117, 117, 117, 117, 117, 117, 117, 117, 117, 117, 117, 117, 117, 117, 117, 117, 117, 239, 0, 0, 0, 0, 237, 117, 117, 117, 117, 117, 117, 117, 117, 117, 117, 117, 117, 117, 117, 117, 117, 117,
278, 278, 278, 278, 278, 278, 278, 278, 278, 278, 278, 278, 278, 278, 278, 278, 278, 279, 0, 0, 0, 0, 237, 117, 117, 117, 117, 117, 117, 117, 117, 117, 117, 117, 117, 117, 117, 117, 117, 117,
0, 0, 0, 0, 0, 0, 0, 0, 0, 0, 0, 0, 0, 0, 0, 0, 0, 0, 0, 0, 0, 0, 237, 117, 117, 117, 117, 397, 398, 398, 398, 398, 398, 398, 399, 117, 117, 117, 117, 117,
0, 0, 0, 0, 0, 0, 0, 0, 0, 0, 0, 0, 0, 0, 0, 0, 0, 0, 0, 0, 0, 0, 237, 117, 117, 117, 397, 359, 317, 317, 317, 317, 317, 317, 358, 399, 117, 117, 117, 117,
0, 0, 0, 0, 0, 0, 0, 0, 0, 0, 0, 0, 0, 0, 0, 0, 0, 0, 0, 0, 0, 0, 237, 117, 117, 117, 437, 317, 438, 438, 438, 438, 317, 317, 317, 439, 117, 117, 117, 117,
0, 0, 0, 0, 0, 0, 0, 0, 0, 0, 0, 0, 0, 0, 0, 0, 0, 0, 0, 0, 0, 0, 237, 117, 117, 117, 437, 438, 438, 438, 438, 438, 438, 317, 317, 439, 117, 117, 117, 117,
0, 0, 0, 0, 0, 0, 0, 0, 0, 0, 0, 0, 0, 0, 0, 0, 0, 0, 0, 0, 0, 0, 237, 117, 117, 117, 437, 317, 317, 317, 317, 317, 317, 317, 317, 439, 117, 117, 117, 117,
198, 198, 198, 198, 198, 198, 198, 198, 198, 198, 198, 198, 198, 198, 198, 199, 0, 0, 0, 0, 0, 0, 237, 117, 117, 117, 437, 317, 317, 317, 317, 317, 317, 317, 317, 439, 117, 117, 117, 117,
117, 117, 117, 117, 117, 117, 117, 117, 117, 117, 117, 117, 117, 117, 117, 239, 0, 0, 0, 0, 0, 0, 237, 117, 117, 117, 437, 438, 438, 317, 317, 438, 438, 317, 317, 439, 117, 117, 117, 117,
117, 117, 117, 117, 117, 117, 117, 117, 117, 117, 117, 117, 117, 117, 117, 239, 0, 0, 0, 0, 0, 0, 237, 117, 117, 117, 437, 438, 438, 317, 317, 438, 438, 317, 317, 439, 117, 117, 117, 117,
117, 117, 117, 117, 117, 117, 117, 117, 117, 117, 117, 117, 117, 117, 117, 239, 0, 0, 0, 0, 0, 0, 237, 117, 117, 117, 477, 319, 317, 317, 317, 317, 317, 317, 318, 479, 117, 117, 117, 117,
117, 117, 117, 117, 117, 117, 117, 117, 117, 117, 117, 117, 117, 117, 117, 239, 0, 0, 0, 0, 0, 0, 237, 117, 117, 117, 117, 477, 478, 478, 478, 478, 478, 478, 479, 117, 117, 117, 117, 117,
117, 117, 117, 117, 117, 117, 117, 117, 117, 117, 117, 117, 117, 117, 117, 239, 0, 0, 0, 0, 0, 0, 237, 117, 117, 117, 117, 117, 117, 117, 117, 117, 117, 117, 117, 117, 117, 117, 117, 117,
117, 117, 117, 117, 117, 117, 117, 117, 117, 117, 117, 117, 117, 117, 117, 239, 0, 0, 0, 0, 0, 0, 237, 117, 117, 117, 117, 117, 117, 117, 117, 117, 117, 117, 117, 117, 117, 117, 117, 117,
117, 117, 117, 117, 117, 117, 117, 117, 117, 117, 117, 117, 117, 117, 117, 239, 0, 0, 0, 0, 0, 0, 237, 117, 117, 117, 117, 397, 398, 398, 398, 398, 398, 398, 399, 117, 117, 117, 117, 117,
117, 117, 117, 117, 117, 117, 117, 117, 117, 117, 117, 117, 117, 117, 117, 239, 0, 0, 0, 0, 0, 0, 237, 117, 117, 117, 397, 359, 317, 317, 317, 317, 317, 317, 358, 399, 117, 117, 117, 117,
117, 117, 117, 117, 117, 117, 117, 117, 117, 117, 117, 117, 117, 117, 117, 239, 0, 0, 0, 0, 0, 0, 237, 117, 117, 117, 437, 438, 438, 317, 317, 438, 438, 317, 317, 439, 117, 117, 117, 117,
117, 117, 117, 117, 117, 117, 117, 117, 117, 117, 117, 117, 117, 117, 117, 239, 0, 0, 0, 0, 0, 0, 237, 117, 117, 117, 437, 438, 438, 317, 317, 438, 438, 317, 317, 439, 117, 117, 117, 117,
278, 278, 278, 278, 278, 278, 278, 278, 278, 278, 278, 278, 278, 278, 278, 279, 0, 0, 0, 0, 0, 0, 237, 117, 117, 117, 437, 317, 317, 317, 317, 317, 317, 317, 317, 439, 117, 117, 117, 117,
0, 0, 0, 0, 0, 0, 0, 0, 0, 0, 0, 0, 0, 0, 0, 0, 0, 0, 0, 0, 0, 0, 237, 117, 117, 117, 437, 317, 317, 317, 317, 317, 317, 317, 317, 439, 117, 117, 117, 117,
0, 0, 0, 0, 0, 0, 0, 0, 0, 0, 0, 0, 0, 0, 0, 0, 0, 0, 0, 0, 0, 0, 237, 117, 117, 117, 437, 438, 438, 438, 438, 438, 438, 317, 317, 439, 117, 117, 117, 117,
0, 0, 0, 0, 0, 0, 0, 0, 0, 0, 0, 0, 0, 0, 0, 0, 0, 0, 0, 0, 0, 0, 237, 117, 117, 117, 437, 317, 438, 438, 438, 438, 317, 317, 317, 439, 117, 117, 117, 117,
0, 0, 0, 0, 0, 0, 0, 0, 0, 0, 0, 0, 0, 0, 0, 0, 0, 0, 0, 0, 0, 0, 237, 117, 117, 117, 477, 319, 317, 317, 317, 317, 317, 317, 318, 479, 117, 117, 117, 117,
0, 0, 0, 0, 0, 0, 0, 0, 0, 0, 0, 0, 0, 0, 0, 0, 0, 0, 0, 0, 0, 0, 237, 117, 117, 117, 117, 477, 478, 478, 478, 478, 478, 478, 479, 117, 117, 117, 117, 117,
198, 198, 198, 198, 198, 198, 198, 198, 198, 198, 198, 198, 198, 198, 198, 198, 198, 198, 198, 198, 198, 198, 159, 117, 117, 117, 117, 117, 117, 117, 117, 117, 117, 117, 117, 117, 117, 117, 117, 117,
117, 117, 117, 117, 117, 117, 117, 117, 117, 117, 117, 117, 117, 117, 117, 117, 117, 117, 117, 117, 117, 117, 117, 117, 117, 117, 117, 117, 117, 117, 117, 117, 117, 117, 117, 117, 117, 117, 117, 117,
117, 117, 117, 117, 117, 117, 117, 117, 117, 117, 117, 117, 117, 117, 117, 117, 117, 117, 117, 117, 117, 117, 117, 117, 117, 117, 117, 117, 117, 117, 117, 117, 117, 117, 117, 117, 117, 117, 117, 117,
117, 117, 117, 117, 117, 117, 117, 117, 117, 117, 117, 117, 117, 117, 117, 117, 117, 117, 117, 117, 117, 117, 117, 117, 117, 117, 117, 117, 117, 117, 117, 117, 117, 117, 117, 117, 117, 117, 117, 117
