TILEMAP
40 30 							-- Size of tile map in tiles
8 8 							-- Tile size & block size
images/tiles.png 	-- Tilesheet
40 30 							-- Number of tiles in tilesheet
484, 484, 484, 484, 484, 484, 484, 484, 484, 484, 484, 484, 484, 484, 484, 484, 484, 484, 484, 484, 484, 484, 484, 484, 484, 484, 484, 484, 484, 484, 484, 484, 484, 484, 484, 484, 484, 484, 484, 484,
484, 484, 484, 484, 484, 484, 484, 484, 484, 484, 484, 484, 484, 484, 484, 484, 484, 484, 484, 484, 484, 484, 484, 484, 484, 484, 484, 484, 484, 484, 484, 484, 484, 484, 484, 484, 484, 484, 484, 484,
484, 484, 484, 484, 484, 484, 484, 484, 484, 484, 484, 484, 484, 484, 484, 484, 484, 484, 484, 484, 484, 484, 484, 484, 484, 484, 484, 484, 484, 484, 484, 484, 484, 484, 484, 484, 484, 484, 484, 484,
484, 484, 484, 485, 645, 645, 645, 645, 645, 645, 645, 645, 645, 645, 645, 645, 645, 645, 645, 645, 645, 645, 645, 645, 645, 645, 645, 645, 645, 645, 645, 645, 645, 645, 645, 645, 645, 645, 645, 645,
484, 484, 484, 606, 0, 0, 0, 0, 10, 10, 10, 0, 0, 0, 0, 10, 10, 10, 0, 0, 0, 0, 0, 0, 0, 0, 0, 0, 0, 0, 10, 10, 0, 0, 0, 0, 0, 0, 10, 10,
484, 484, 484, 606, 0, 0, 0, 0, 0, 0, 0, 0, 0, 0, 0, 0, 0, 0, 0, 0, 0, 0, 0, 0, 0, 0, 0, 0, 0, 0, 0, 0, 0, 0, 0, 0, 0, 0, 0, 0,
484, 484, 484, 606, 0, 0, 0, 0, 0, 0, 0, 0, 0, 0, 0, 0, 0, 0, 0, 0, 0, 0, 0, 0, 0, 0, 0, 0, 0, 0, 0, 0, 0, 0, 0, 0, 0, 0, 0, 0,
484, 484, 484, 606, 0, 0, 0, 0, 0, 0, 0, 0, 0, 0, 0, 0, 0, 0, 0, 0, 9, 9, 9, 9, 0, 0, 0, 0, 0, 0, 0, 0, 0, 0, 0, 0, 0, 0, 0, 0,
484, 484, 484, 606, 0, 0, 0, 564, 565, 565, 565, 566, 0, 0, 564, 565, 565, 565, 565, 565, 565, 565, 565, 565, 565, 565, 566, 0, 0, 564, 565, 566, 0, 0, 0, 51, 564, 565, 565, 565,
484, 484, 484, 606, 0, 0, 0, 644, 645, 645, 645, 646, 0, 0, 644, 645, 645, 645, 645, 645, 645, 645, 645, 645, 645, 645, 646, 0, 0, 644, 645, 646, 0, 0, 0, 51, 604, 484, 484, 484,
484, 484, 484, 606, 0, 0, 0, 0, 0, 0, 0, 0, 0, 0, 0, 0, 0, 0, 0, 0, 0, 0, 0, 0, 0, 0, 0, 0, 0, 0, 0, 0, 0, 0, 0, 51, 604, 484, 484, 484,
484, 484, 484, 606, 0, 0, 0, 0, 0, 0, 0, 0, 0, 0, 0, 0, 0, 0, 0, 0, 0, 0, 0, 0, 0, 0, 0, 0, 0, 0, 0, 0, 0, 0, 0, 51, 604, 484, 484, 484,
484, 484, 484, 606, 0, 0, 0, 0, 0, 0, 0, 0, 0, 0, 0, 0, 0, 0, 0, 0, 0, 0, 0, 0, 0, 0, 0, 0, 0, 0, 0, 0, 0, 0, 0, 51, 604, 484, 484, 484,
484, 484, 484, 606, 0, 0, 0, 564, 565, 565, 565, 565, 565, 565, 565, 565, 565, 565, 566, 0, 0, 0, 564, 565, 565, 565, 565, 565, 565, 565, 565, 565, 565, 565, 565, 565, 526, 484, 484, 484,
484, 484, 484, 606, 0, 0, 0, 644, 645, 645, 645, 645, 645, 645, 645, 645, 645, 486, 606, 0, 0, 0, 604, 485, 645, 645, 645, 645, 645, 645, 645, 645, 645, 645, 645, 645, 486, 484, 484, 484,
484, 484, 484, 606, 0, 0, 0, 0, 0, 0, 0, 0, 0, 0, 0, 0, 0, 604, 525, 565, 565, 565, 526, 606, 0, 0, 0, 0, 0, 0, 0, 0, 0, 0, 0, 0, 604, 484, 484, 484,
484, 484, 484, 606, 0, 0, 0, 0, 0, 0, 0, 0, 0, 0, 0, 0, 0, 644, 645, 645, 645, 645, 645, 646, 0, 0, 0, 0, 0, 0, 0, 0, 0, 0, 0, 0, 604, 484, 484, 484,
484, 484, 484, 606, 0, 0, 0, 0, 0, 0, 0, 0, 0, 0, 0, 0, 0, 0, 10, 10, 10, 10, 10, 0, 0, 0, 0, 0, 0, 0, 0, 0, 0, 0, 0, 0, 604, 484, 484, 484,
484, 484, 484, 606, 0, 0, 0, 0, 0, 0, 0, 0, 0, 0, 0, 0, 0, 0, 0, 0, 0, 0, 0, 0, 0, 0, 0, 0, 0, 0, 0, 0, 0, 0, 0, 0, 604, 484, 484, 484,
484, 484, 484, 606, 0, 0, 0, 0, 0, 0, 0, 0, 0, 0, 0, 0, 0, 0, 0, 0, 0, 0, 0, 0, 0, 0, 0, 0, 0, 0, 0, 0, 0, 0, 0, 0, 604, 484, 484, 484,
484, 484, 484, 606, 0, 0, 0, 0, 0, 0, 0, 0, 0, 0, 0, 0, 0, 0, 0, 0, 0, 0, 0, 0, 0, 0, 0, 0, 0, 0, 0, 0, 0, 0, 0, 0, 604, 484, 484, 484,
484, 484, 484, 525, 565, 565, 565, 565, 565, 565, 565, 565, 565, 565, 565, 565, 565, 565, 565, 565, 565, 565, 565, 566, 0, 0, 564, 565, 566, 0, 0, 564, 566, 0, 0, 0, 604, 484, 484, 484,
484, 484, 484, 485, 645, 645, 645, 645, 645, 645, 645, 645, 645, 645, 645, 645, 645, 645, 645, 645, 645, 645, 645, 646, 0, 0, 644, 645, 646, 0, 0, 644, 646, 0, 0, 0, 604, 484, 484, 484,
484, 484, 484, 606, 0, 0, 0, 0, 0, 0, 0, 0, 0, 0, 0, 0, 0, 0, 0, 0, 0, 0, 0, 0, 0, 0, 0, 0, 0, 0, 0, 0, 0, 0, 0, 0, 604, 484, 484, 484,
484, 484, 484, 606, 0, 0, 0, 0, 0, 0, 0, 0, 0, 0, 0, 0, 0, 0, 0, 0, 0, 0, 0, 0, 0, 0, 0, 0, 0, 0, 0, 0, 0, 0, 0, 0, 604, 484, 484, 484,
484, 484, 484, 606, 0, 0, 0, 0, 0, 0, 0, 0, 0, 0, 0, 0, 0, 0, 0, 0, 0, 0, 0, 0, 0, 0, 0, 0, 0, 0, 0, 0, 0, 0, 0, 0, 604, 484, 484, 484,
484, 484, 484, 525, 565, 565, 565, 565, 565, 565, 565, 565, 565, 565, 565, 565, 565, 565, 565, 565, 565, 565, 565, 565, 565, 565, 565, 565, 565, 565, 565, 565, 565, 565, 565, 565, 526, 484, 484, 484,
484, 484, 484, 484, 484, 484, 484, 484, 484, 484, 484, 484, 484, 484, 484, 484, 484, 484, 484, 484, 484, 484, 484, 484, 484, 484, 484, 484, 484, 484, 484, 484, 484, 484, 484, 484, 484, 484, 484, 484,
484, 484, 484, 484, 484, 484, 484, 484, 484, 484, 484, 484, 484, 484, 484, 484, 484, 484, 484, 484, 484, 484, 484, 484, 484, 484, 484, 484, 484, 484, 484, 484, 484, 484, 484, 484, 484, 484, 484, 484,
484, 484, 484, 484, 484, 484, 484, 484, 484, 484, 484, 484, 484, 484, 484, 484, 484, 484, 484, 484, 484, 484, 484, 484, 484, 484, 484, 484, 484, 484, 484, 484, 484, 484, 484, 484, 484, 484, 484, 484
      }
