TILEMAP
40 30 							-- Size of tile map in tiles
8 8 							-- Tile size & block size
images/tiles.png 	-- Tilesheet
40 30 							-- Number of tiles in tilesheet
502, 502, 502, 502, 502, 502, 502, 502, 502, 502, 502, 502, 502, 502, 502, 502, 502, 502, 502, 502, 502, 502, 502, 502, 502, 502, 502, 502, 502, 502, 502, 502, 502, 502, 502, 502, 502, 502, 502, 502,
502, 502, 502, 502, 502, 502, 502, 502, 502, 502, 502, 502, 502, 502, 502, 502, 502, 502, 502, 502, 502, 502, 502, 502, 502, 502, 502, 502, 502, 502, 502, 502, 502, 502, 502, 502, 502, 502, 502, 502,
502, 502, 502, 502, 502, 502, 502, 502, 502, 502, 502, 502, 502, 502, 502, 502, 502, 502, 502, 502, 502, 502, 502, 502, 502, 502, 502, 502, 502, 502, 502, 502, 502, 502, 502, 502, 502, 502, 502, 502,
663, 663, 663, 663, 663, 663, 663, 663, 663, 663, 663, 663, 663, 663, 663, 663, 504, 502, 502, 502, 503, 663, 663, 663, 663, 663, 663, 663, 663, 663, 663, 663, 663, 663, 663, 663, 504, 502, 502, 502,
0, 0, 0, 0, 0, 0, 0, 0, 0, 0, 0, 0, 0, 0, 0, 0, 622, 502, 502, 502, 624, 0, 0, 0, 0, 0, 0, 0, 0, 0, 0, 0, 0, 0, 0, 0, 622, 502, 502, 502,
0, 0, 0, 0, 0, 0, 0, 0, 0, 0, 0, 0, 0, 0, 0, 0, 622, 502, 502, 502, 624, 0, 0, 0, 0, 0, 0, 0, 0, 0, 0, 0, 0, 0, 0, 0, 622, 502, 502, 502,
0, 0, 0, 0, 0, 0, 0, 0, 0, 0, 0, 0, 0, 0, 0, 0, 622, 502, 502, 502, 624, 0, 0, 0, 0, 0, 0, 0, 0, 0, 0, 0, 0, 0, 0, 0, 622, 502, 502, 502,
9, 9, 9, 9, 9, 9, 9, 9, 9, 9, 9, 0, 0, 0, 0, 0, 622, 502, 502, 502, 624, 0, 0, 0, 0, 0, 9, 9, 9, 9, 9, 9, 9, 0, 0, 0, 622, 502, 502, 502,
583, 583, 583, 583, 583, 583, 583, 583, 583, 583, 584, 50, 0, 0, 0, 51, 622, 502, 502, 502, 624, 50, 0, 0, 0, 51, 582, 583, 583, 583, 583, 583, 584, 0, 0, 0, 622, 502, 502, 502,
502, 502, 502, 502, 502, 502, 502, 502, 503, 663, 664, 50, 0, 0, 0, 51, 662, 663, 663, 663, 664, 50, 0, 0, 0, 51, 662, 663, 504, 502, 502, 502, 624, 0, 0, 0, 622, 502, 502, 502,
502, 502, 502, 502, 502, 502, 502, 502, 624, 0, 0, 0, 0, 0, 0, 0, 10, 10, 10, 10, 10, 0, 0, 0, 0, 0, 0, 0, 622, 502, 502, 502, 624, 0, 0, 0, 622, 502, 502, 502,
502, 502, 502, 502, 502, 502, 502, 502, 624, 0, 0, 0, 0, 0, 0, 0, 9, 9, 9, 9, 9, 0, 0, 0, 0, 0, 0, 0, 622, 502, 502, 502, 624, 0, 0, 0, 622, 502, 502, 502,
502, 502, 502, 502, 502, 502, 502, 502, 543, 583, 584, 50, 0, 0, 0, 51, 582, 583, 583, 583, 584, 50, 0, 0, 0, 51, 582, 583, 544, 502, 502, 502, 624, 0, 0, 0, 622, 502, 502, 502,
502, 502, 502, 502, 502, 502, 502, 502, 502, 502, 624, 50, 0, 0, 0, 51, 622, 502, 502, 502, 624, 50, 0, 0, 0, 51, 622, 502, 502, 502, 502, 502, 624, 0, 0, 0, 622, 502, 502, 502,
502, 502, 502, 502, 502, 502, 502, 502, 502, 502, 624, 50, 0, 0, 0, 51, 622, 502, 502, 502, 624, 50, 0, 0, 0, 51, 622, 502, 502, 502, 502, 502, 624, 0, 0, 0, 622, 502, 502, 502,
502, 502, 502, 502, 502, 502, 502, 502, 502, 502, 624, 50, 0, 0, 0, 51, 622, 502, 502, 502, 624, 50, 0, 0, 0, 51, 622, 502, 502, 502, 502, 502, 624, 0, 0, 0, 622, 502, 502, 502,
502, 502, 502, 502, 502, 502, 502, 502, 502, 502, 624, 50, 0, 0, 0, 51, 622, 502, 502, 502, 624, 50, 0, 0, 0, 51, 622, 502, 502, 502, 502, 502, 624, 0, 0, 0, 622, 502, 502, 502,
502, 502, 502, 502, 502, 502, 502, 502, 503, 663, 664, 50, 0, 0, 0, 51, 662, 663, 663, 663, 664, 50, 0, 0, 0, 51, 662, 663, 504, 502, 502, 502, 624, 0, 0, 0, 622, 502, 502, 502,
502, 502, 502, 502, 502, 502, 502, 502, 624, 0, 0, 0, 0, 0, 0, 0, 10, 10, 10, 10, 10, 0, 0, 0, 0, 0, 0, 0, 622, 502, 502, 502, 624, 0, 0, 0, 622, 502, 502, 502,
502, 502, 502, 502, 502, 502, 502, 502, 624, 0, 0, 0, 0, 0, 0, 0, 9, 9, 9, 9, 9, 0, 0, 0, 0, 0, 0, 0, 622, 502, 502, 502, 624, 0, 0, 0, 622, 502, 502, 502,
502, 502, 502, 502, 502, 502, 502, 502, 543, 583, 584, 50, 0, 0, 0, 51, 582, 583, 583, 583, 584, 50, 0, 0, 0, 51, 582, 583, 544, 502, 502, 502, 624, 0, 0, 0, 622, 502, 502, 502,
502, 502, 502, 502, 502, 502, 502, 502, 502, 502, 624, 50, 0, 0, 0, 51, 662, 663, 663, 663, 664, 50, 0, 0, 0, 51, 622, 502, 502, 502, 502, 502, 624, 0, 0, 0, 622, 502, 502, 502,
502, 502, 502, 502, 502, 502, 502, 502, 502, 502, 624, 0, 0, 0, 0, 0, 10, 10, 10, 10, 10, 0, 0, 0, 0, 0, 622, 502, 502, 502, 502, 502, 624, 0, 0, 0, 622, 502, 502, 502,
502, 502, 502, 502, 502, 502, 502, 502, 502, 502, 624, 0, 0, 0, 0, 0, 0, 0, 0, 0, 0, 0, 0, 0, 0, 0, 622, 502, 502, 502, 502, 502, 624, 0, 0, 0, 622, 502, 502, 502,
502, 502, 502, 502, 502, 502, 502, 502, 502, 502, 624, 0, 0, 0, 0, 0, 0, 0, 0, 0, 0, 0, 0, 0, 0, 0, 622, 502, 502, 502, 502, 502, 624, 0, 0, 0, 622, 502, 502, 502,
502, 502, 502, 502, 502, 502, 502, 502, 502, 502, 624, 0, 0, 0, 0, 0, 0, 0, 0, 0, 0, 0, 0, 0, 0, 0, 622, 502, 502, 502, 502, 502, 624, 0, 0, 0, 622, 502, 502, 502,
502, 502, 502, 502, 502, 502, 502, 502, 502, 502, 543, 583, 583, 583, 583, 583, 583, 583, 583, 583, 583, 583, 583, 583, 583, 583, 544, 502, 502, 502, 502, 502, 624, 0, 0, 0, 622, 502, 502, 502,
502, 502, 502, 502, 502, 502, 502, 502, 502, 502, 502, 502, 502, 502, 502, 502, 502, 502, 502, 502, 502, 502, 502, 502, 502, 502, 502, 502, 502, 502, 502, 502, 624, 0, 0, 0, 622, 502, 502, 502,
502, 502, 502, 502, 502, 502, 502, 502, 502, 502, 502, 502, 502, 502, 502, 502, 502, 502, 502, 502, 502, 502, 502, 502, 502, 502, 502, 502, 502, 502, 502, 502, 624, 0, 0, 0, 622, 502, 502, 502,
502, 502, 502, 502, 502, 502, 502, 502, 502, 502, 502, 502, 502, 502, 502, 502, 502, 502, 502, 502, 502, 502, 502, 502, 502, 502, 502, 502, 502, 502, 502, 502, 624, 0, 0, 0, 622, 502, 502, 502