TILEMAP
40 30 							-- Size of tile map in tiles
8 8 							-- Tile size & block size
images/tiles.png 	-- Tilesheet
40 30 							-- Number of tiles in tilesheet
317, 317, 317, 317, 317, 317, 317, 317, 317, 317, 317, 317, 317, 317, 317, 317, 317, 317, 317, 317, 317, 317, 317, 317, 317, 317, 317, 317, 317, 317, 317, 317, 317, 317, 317, 317, 317, 317, 317, 317,
317, 317, 317, 317, 317, 317, 317, 317, 317, 317, 317, 317, 317, 317, 317, 317, 317, 317, 317, 317, 317, 317, 317, 317, 317, 317, 317, 317, 317, 317, 317, 317, 317, 317, 317, 317, 317, 317, 317, 317,
317, 317, 317, 317, 317, 317, 317, 317, 317, 317, 317, 317, 317, 317, 317, 317, 317, 317, 317, 317, 317, 317, 317, 317, 317, 317, 317, 317, 317, 317, 317, 317, 317, 317, 317, 317, 317, 317, 317, 317,
317, 317, 317, 318, 478, 478, 478, 478, 478, 478, 478, 478, 478, 478, 478, 478, 478, 478, 478, 478, 478, 478, 478, 478, 478, 478, 478, 478, 478, 478, 478, 478, 478, 478, 478, 478, 319, 317, 317, 317,
317, 317, 317, 439, 0, 0, 0, 0, 0, 0, 0, 0, 0, 0, 0, 0, 0, 0, 0, 0, 0, 0, 0, 0, 0, 0, 0, 0, 0, 0, 0, 0, 0, 0, 0, 0, 437, 317, 317, 317,
317, 317, 317, 439, 0, 0, 0, 0, 0, 0, 0, 0, 0, 0, 0, 0, 0, 0, 0, 0, 0, 0, 0, 0, 0, 0, 0, 0, 0, 0, 0, 0, 0, 0, 0, 0, 437, 317, 317, 317,
317, 317, 317, 439, 0, 0, 0, 0, 0, 0, 0, 0, 0, 0, 0, 0, 0, 0, 0, 0, 0, 0, 0, 0, 0, 0, 0, 0, 0, 0, 0, 0, 0, 0, 0, 0, 437, 317, 317, 317,
317, 317, 317, 439, 0, 0, 0, 0, 0, 0, 0, 0, 0, 0, 0, 0, 0, 0, 0, 0, 0, 0, 0, 0, 0, 0, 0, 0, 0, 0, 0, 0, 0, 0, 0, 0, 437, 317, 317, 317,
317, 317, 317, 439, 0, 0, 0, 0, 0, 0, 0, 0, 0, 397, 398, 398, 398, 398, 398, 398, 398, 398, 398, 398, 399, 0, 0, 0, 0, 397, 398, 399, 0, 0, 0, 0, 437, 317, 317, 317,
317, 317, 317, 358, 398, 398, 399, 0, 0, 0, 0, 0, 397, 359, 317, 317, 317, 317, 317, 317, 317, 317, 317, 438, 438, 438, 0, 0, 438, 438, 438, 439, 0, 0, 0, 0, 437, 317, 317, 317,
317, 317, 317, 317, 317, 438, 438, 438, 0, 0, 0, 0, 437, 438, 438, 317, 317, 438, 438, 317, 317, 318, 478, 478, 479, 0, 0, 0, 0, 477, 478, 479, 0, 0, 0, 0, 437, 317, 317, 317,
317, 317, 317, 318, 478, 478, 479, 0, 0, 0, 0, 0, 437, 438, 438, 317, 317, 438, 438, 317, 317, 439, 0, 0, 0, 0, 0, 0, 0, 0, 0, 0, 0, 0, 0, 0, 437, 317, 317, 317,
317, 317, 317, 439, 0, 0, 0, 0, 0, 0, 0, 0, 437, 317, 317, 317, 317, 317, 317, 317, 317, 439, 0, 0, 0, 0, 0, 0, 0, 0, 0, 0, 0, 0, 0, 0, 437, 317, 317, 317,
317, 317, 317, 439, 0, 0, 0, 0, 0, 0, 0, 0, 437, 317, 317, 317, 317, 317, 317, 317, 317, 439, 0, 0, 0, 0, 0, 0, 0, 0, 0, 0, 0, 0, 0, 0, 437, 317, 317, 317,
317, 317, 317, 439, 0, 0, 0, 0, 0, 0, 0, 0, 437, 438, 438, 438, 438, 438, 438, 317, 317, 439, 0, 0, 0, 0, 0, 0, 0, 0, 0, 0, 0, 0, 0, 0, 437, 317, 317, 317,
317, 317, 317, 439, 0, 0, 0, 0, 0, 0, 0, 0, 437, 317, 438, 438, 438, 438, 317, 317, 317, 439, 0, 0, 0, 397, 398, 398, 398, 398, 398, 398, 398, 398, 398, 398, 359, 317, 317, 317,
317, 317, 317, 439, 0, 0, 0, 0, 0, 0, 0, 0, 477, 319, 317, 317, 317, 317, 317, 317, 318, 479, 0, 0, 0, 477, 319, 317, 317, 317, 317, 317, 317, 317, 317, 317, 317, 317, 317, 317,
317, 317, 317, 439, 0, 0, 0, 0, 0, 0, 0, 0, 0, 477, 478, 478, 478, 478, 478, 478, 479, 0, 0, 0, 0, 0, 477, 478, 478, 478, 478, 478, 478, 478, 478, 478, 478, 478, 478, 478,
317, 317, 317, 358, 398, 398, 399, 0, 0, 0, 0, 0, 0, 0, 0, 0, 0, 0, 0, 0, 0, 0, 0, 0, 0, 0, 0, 0, 0, 0, 0, 0, 0, 0, 0, 0, 0, 0, 0, 0,
317, 317, 317, 317, 317, 438, 438, 438, 0, 0, 0, 0, 0, 0, 0, 0, 0, 0, 0, 0, 0, 0, 0, 0, 0, 0, 0, 0, 0, 0, 0, 0, 0, 0, 0, 0, 0, 0, 0, 0,
317, 317, 317, 318, 478, 478, 479, 0, 0, 0, 0, 0, 0, 0, 0, 0, 0, 0, 0, 0, 0, 0, 0, 0, 0, 0, 0, 0, 0, 0, 0, 0, 0, 0, 0, 0, 0, 0, 0, 0,
317, 317, 317, 439, 0, 0, 0, 0, 0, 0, 0, 0, 0, 0, 0, 0, 0, 0, 0, 0, 0, 0, 0, 0, 0, 0, 0, 0, 0, 0, 0, 0, 0, 0, 0, 0, 0, 0, 0, 0,
317, 317, 317, 439, 0, 0, 0, 0, 0, 0, 0, 0, 0, 0, 0, 0, 0, 0, 0, 0, 0, 0, 0, 0, 0, 0, 0, 0, 0, 0, 0, 0, 0, 0, 0, 0, 0, 0, 0, 0,
317, 317, 317, 439, 0, 0, 0, 0, 0, 0, 0, 0, 0, 0, 0, 0, 0, 0, 0, 0, 0, 0, 0, 0, 0, 0, 0, 0, 0, 0, 0, 0, 0, 0, 0, 0, 0, 0, 0, 0,
317, 317, 317, 439, 0, 0, 0, 0, 0, 0, 0, 0, 0, 0, 0, 0, 0, 0, 0, 0, 0, 0, 0, 0, 0, 0, 0, 0, 0, 0, 0, 0, 0, 0, 0, 0, 0, 0, 0, 0,
317, 317, 317, 439, 0, 0, 0, 0, 0, 0, 0, 0, 0, 9, 9, 9, 9, 9, 9, 9, 9, 9, 9, 9, 9, 9, 9, 9, 9, 9, 9, 9, 9, 9, 9, 9, 9, 9, 9, 9,
317, 317, 317, 439, 0, 0, 0, 0, 0, 397, 398, 398, 398, 398, 398, 398, 398, 398, 398, 398, 398, 398, 398, 398, 398, 398, 398, 398, 398, 398, 398, 398, 398, 398, 398, 398, 398, 398, 398, 398,
317, 317, 317, 439, 0, 0, 0, 0, 0, 437, 317, 317, 317, 317, 317, 317, 317, 317, 317, 317, 317, 317, 317, 317, 317, 317, 317, 317, 317, 317, 317, 317, 317, 317, 317, 317, 317, 317, 317, 317,
317, 317, 317, 439, 0, 0, 0, 0, 0, 437, 317, 317, 317, 317, 317, 317, 317, 317, 317, 317, 317, 317, 317, 317, 317, 317, 317, 317, 317, 317, 317, 317, 317, 317, 317, 317, 317, 317, 317, 317,
317, 317, 317, 439, 0, 0, 0, 0, 0, 437, 317, 317, 317, 317, 317, 317, 317, 317, 317, 317, 317, 317, 317, 317, 317, 317, 317, 317, 317, 317, 317, 317, 317, 317, 317, 317, 317, 317, 317, 317