TILEMAP
40 30 							-- Size of tile map in tiles
8 8 							-- Tile size & block size
images/tiles.png 	-- Tilesheet
40 30 							-- Number of tiles in tilesheet
705, 705, 705, 827, 0, 0, 0, 0, 0, 825, 705, 705, 705, 705, 705, 705, 705, 705, 705, 705, 705, 705, 705, 705, 705, 705, 705, 705, 705, 705, 705, 705, 705, 705, 705, 705, 705, 705, 705, 705,
705, 705, 705, 827, 0, 0, 0, 0, 0, 825, 705, 705, 705, 705, 705, 705, 705, 705, 705, 705, 705, 705, 705, 705, 705, 705, 705, 705, 705, 705, 705, 705, 705, 705, 705, 705, 705, 705, 705, 705,
705, 705, 705, 827, 0, 0, 0, 0, 0, 825, 706, 866, 866, 866, 866, 866, 866, 866, 866, 866, 866, 866, 866, 866, 866, 866, 866, 866, 866, 866, 866, 866, 866, 866, 707, 705, 705, 705, 705, 705,
705, 705, 705, 827, 0, 0, 0, 0, 0, 865, 867, 1033, 1033, 1033, 1033, 1033, 1033, 1033, 1033, 1033, 1033, 1033, 1033, 1033, 1033, 1033, 1033, 1033, 1033, 1033, 1033, 1033, 1033, 1033, 865, 866, 866, 866, 866, 866,
705, 705, 705, 827, 0, 0, 0, 0, 0, 0, 0, 0, 0, 0, 0, 0, 0, 0, 0, 0, 0, 0, 10, 10, 0, 0, 0, 0, 0, 0, 0, 0, 0, 0, 0, 0, 0, 0, 10, 10,
705, 705, 705, 827, 0, 0, 0, 0, 0, 0, 0, 0, 0, 0, 0, 0, 0, 0, 0, 0, 0, 0, 0, 0, 0, 0, 0, 0, 0, 0, 0, 0, 0, 0, 0, 0, 0, 0, 0, 0,
705, 705, 705, 827, 0, 0, 0, 0, 0, 0, 0, 0, 0, 0, 0, 0, 0, 0, 0, 0, 0, 0, 0, 0, 0, 0, 0, 0, 0, 0, 0, 0, 0, 0, 0, 0, 0, 0, 0, 0,
705, 705, 705, 827, 0, 0, 0, 0, 0, 0, 0, 0, 0, 0, 0, 0, 0, 0, 0, 0, 0, 0, 0, 0, 0, 0, 0, 0, 0, 0, 0, 0, 0, 0, 0, 0, 0, 0, 0, 0,
705, 705, 705, 827, 0, 0, 0, 0, 0, 0, 0, 0, 0, 0, 0, 9, 9, 0, 0, 0, 0, 0, 0, 0, 0, 0, 0, 0, 9, 9, 0, 0, 0, 0, 0, 0, 0, 0, 0, 0,
705, 705, 705, 746, 786, 786, 786, 786, 786, 786, 787, 1032, 1032, 1032, 1032, 1032, 1032, 1032, 1032, 1032, 1032, 1032, 1032, 1032, 1032, 1032, 1032, 1032, 1032, 1032, 1032, 1032, 1032, 1032, 785, 786, 786, 786, 786, 786,
705, 705, 705, 705, 705, 705, 705, 705, 705, 705, 746, 786, 786, 786, 786, 786, 786, 786, 786, 786, 786, 786, 786, 786, 786, 786, 786, 786, 786, 786, 786, 786, 786, 786, 747, 745, 745, 745, 745, 745,
705, 705, 705, 705, 745, 705, 705, 705, 705, 705, 705, 705, 705, 705, 705, 705, 705, 705, 705, 705, 705, 705, 705, 705, 705, 705, 705, 705, 705, 705, 705, 705, 705, 705, 705, 745, 745, 745, 745, 745,
705, 705, 705, 745, 745, 705, 705, 705, 705, 705, 705, 705, 705, 705, 705, 705, 705, 705, 705, 705, 705, 705, 705, 705, 705, 705, 705, 705, 705, 705, 705, 705, 705, 705, 705, 745, 705, 705, 705, 705,
705, 705, 705, 706, 866, 866, 866, 866, 866, 866, 866, 866, 866, 866, 866, 866, 866, 866, 866, 866, 866, 866, 866, 866, 866, 866, 866, 866, 866, 866, 866, 866, 866, 866, 866, 866, 866, 866, 866, 866,
705, 705, 705, 827, 0, 0, 0, 0, 0, 0, 0, 0, 0, 0, 0, 0, 0, 0, 0, 0, 0, 0, 0, 0, 0, 0, 0, 0, 0, 0, 0, 0, 0, 0, 0, 0, 0, 0, 0, 0,
705, 705, 705, 827, 0, 0, 0, 0, 0, 0, 0, 0, 0, 0, 0, 0, 0, 0, 0, 0, 0, 0, 0, 0, 0, 0, 0, 0, 0, 0, 0, 0, 0, 0, 0, 0, 0, 0, 0, 0,
705, 705, 705, 827, 0, 0, 0, 0, 0, 0, 0, 0, 0, 0, 0, 0, 0, 0, 0, 0, 0, 0, 0, 0, 0, 0, 0, 0, 0, 0, 0, 0, 0, 0, 0, 0, 0, 0, 0, 0,
705, 705, 705, 827, 0, 0, 0, 0, 0, 0, 0, 0, 0, 0, 0, 0, 0, 0, 0, 0, 0, 0, 0, 0, 0, 0, 0, 0, 0, 0, 0, 0, 0, 0, 0, 0, 0, 0, 0, 0,
705, 705, 705, 827, 0, 0, 0, 0, 0, 0, 0, 0, 0, 0, 0, 0, 0, 0, 0, 0, 0, 0, 0, 0, 0, 0, 0, 0, 0, 0, 0, 0, 0, 0, 0, 0, 0, 0, 0, 0,
705, 705, 705, 827, 0, 0, 0, 0, 826, 826, 826, 826, 826, 826, 826, 826, 826, 826, 826, 826, 826, 826, 826, 826, 826, 826, 826, 826, 826, 826, 826, 826, 826, 826, 826, 826, 826, 826, 826, 826,
705, 705, 705, 827, 0, 0, 0, 0, 826, 826, 826, 826, 826, 826, 826, 826, 826, 826, 826, 826, 826, 826, 826, 826, 826, 826, 826, 826, 826, 826, 826, 826, 826, 826, 826, 826, 826, 826, 826, 826,
705, 705, 705, 827, 0, 0, 0, 0, 0, 0, 0, 10, 10, 10, 10, 10, 0, 0, 0, 0, 0, 0, 0, 0, 0, 0, 0, 0, 0, 0, 0, 0, 0, 0, 0, 10, 10, 10, 10, 10,
705, 705, 705, 827, 0, 0, 0, 0, 0, 0, 0, 0, 0, 0, 0, 0, 0, 0, 0, 0, 0, 0, 0, 0, 0, 0, 0, 0, 0, 0, 0, 0, 0, 0, 0, 0, 0, 0, 0, 0,
705, 705, 705, 827, 0, 0, 0, 0, 0, 0, 0, 0, 0, 0, 0, 0, 0, 0, 0, 0, 0, 0, 0, 0, 0, 0, 0, 0, 0, 0, 0, 0, 0, 0, 0, 0, 0, 0, 0, 0,
705, 705, 705, 827, 0, 0, 0, 0, 0, 0, 0, 0, 0, 0, 0, 0, 0, 0, 0, 0, 0, 0, 0, 0, 0, 0, 0, 0, 0, 0, 0, 0, 0, 0, 0, 0, 0, 0, 0, 0,
705, 705, 705, 827, 0, 0, 0, 0, 0, 0, 0, 0, 0, 0, 0, 0, 0, 0, 0, 9, 9, 9, 9, 9, 0, 0, 0, 9, 9, 9, 9, 9, 0, 0, 0, 0, 0, 0, 0, 0,
705, 705, 705, 746, 786, 786, 786, 786, 786, 786, 786, 786, 786, 786, 786, 786, 786, 786, 786, 786, 786, 786, 786, 786, 786, 786, 786, 786, 786, 786, 786, 786, 786, 786, 786, 786, 786, 786, 786, 786,
705, 705, 705, 705, 705, 705, 705, 705, 705, 705, 705, 705, 705, 705, 705, 705, 705, 705, 705, 705, 705, 705, 705, 705, 705, 705, 705, 705, 705, 705, 705, 705, 705, 705, 705, 705, 705, 705, 705, 705,
705, 705, 705, 705, 705, 705, 705, 705, 705, 705, 705, 705, 705, 705, 705, 705, 705, 705, 705, 705, 705, 705, 705, 705, 705, 705, 705, 705, 705, 705, 705, 705, 705, 705, 705, 705, 705, 705, 705, 705,
705, 705, 705, 705, 705, 705, 705, 705, 705, 705, 705, 705, 705, 705, 705, 705, 705, 705, 705, 705, 705, 705, 705, 705, 705, 705, 705, 705, 705, 705, 705, 705, 705, 705, 705, 705, 705, 705, 705, 705